

#########################
#              P        #
#                       #
#         O             #
#                       #
#          X            #
#########################